5,5,5,5,5,5,5,5,0,0,0,0,0,5,5,5,5,5,5,5,5
5,5,5,5,5,5,5,5,0,5,1,5,0,5,5,5,5,5,5,5,5
5,5,5,5,5,5,0,0,5,5,3,5,5,0,0,5,5,5,5,5,5
5,5,5,5,5,0,5,5,5,5,1,5,5,5,5,0,5,5,5,5,5
5,5,5,5,0,5,5,5,5,5,1,5,5,5,5,5,0,5,5,5,5
5,5,5,5,0,5,5,5,5,5,1,5,5,5,5,5,0,5,5,5,5
5,5,5,0,5,5,5,5,5,5,1,5,5,5,5,5,5,0,5,5,5
5,5,5,0,5,5,5,5,5,5,1,5,5,5,5,5,5,0,5,5,5
5,5,0,5,5,5,5,5,5,5,1,5,5,5,5,5,5,5,0,5,5
5,5,0,5,5,5,5,5,5,5,1,5,5,5,5,5,5,5,0,5,5
5,5,0,5,5,5,5,5,5,5,1,5,5,5,5,5,5,5,0,5,5
5,5,0,5,5,5,5,5,5,5,1,5,5,5,5,5,5,5,0,5,5
5,5,0,5,5,5,5,5,5,5,4,5,5,5,5,5,5,5,0,5,5
5,5,0,5,5,5,5,5,5,5,1,5,5,5,5,5,5,5,0,5,5
5,5,0,5,5,5,5,5,5,5,1,5,5,5,5,5,5,5,0,5,5
5,5,0,5,5,5,5,5,5,5,1,5,5,5,5,5,5,5,0,5,5
5,5,0,5,5,5,5,5,5,5,1,5,5,5,5,5,5,5,0,5,5
5,5,0,5,5,5,5,5,5,5,1,5,5,5,5,5,5,5,0,5,5
5,5,5,0,5,5,5,5,5,5,1,5,5,5,5,5,5,0,5,5,5
5,5,5,0,5,5,5,5,5,5,1,5,5,5,5,5,5,0,5,5,5
5,5,5,5,0,5,5,5,5,5,1,5,5,5,5,5,0,5,5,5,5
5,5,5,5,0,5,5,5,5,5,1,5,5,5,5,5,0,5,5,5,5
5,5,5,5,5,0,5,5,5,5,2,5,5,5,5,0,5,5,5,5,5
5,5,5,5,5,5,0,0,5,5,1,5,5,0,0,5,5,5,5,5,5
5,5,5,5,5,5,5,5,0,5,1,5,0,5,5,5,5,5,5,5,5
5,5,5,5,5,5,5,5,0,0,0,0,0,5,5,5,5,5,5,5,5
