0,0,0,0,0,0,0,0,0,0,0,0,0,0,0,0,0,0,0,0,0,0,0
0,0,0,0,0,0,5,5,0,0,5,5,5,0,0,5,5,0,0,0,0,0,0
0,0,0,0,5,5,5,5,5,5,5,5,5,5,5,5,5,5,5,0,0,0,0
0,0,0,5,5,1,1,5,5,5,5,5,5,5,5,5,1,1,5,5,0,0,0
0,0,5,5,1,1,1,1,1,1,1,1,1,1,1,1,1,1,1,5,5,0,0
0,0,5,1,1,1,1,1,1,1,1,1,1,1,1,1,1,1,1,1,5,0,0
0,5,5,1,1,1,1,1,1,1,1,3,1,1,1,1,1,1,1,1,5,5,0
0,5,5,5,1,1,1,1,1,1,1,1,1,1,1,1,1,1,1,5,5,5,0
0,0,5,5,1,1,1,1,1,1,1,1,1,1,1,1,1,1,1,5,5,0,0
0,0,5,5,1,1,1,1,1,1,1,1,1,1,1,1,1,1,1,5,5,0,0
0,5,5,5,1,1,1,1,1,1,1,4,1,1,1,1,1,1,1,5,5,5,0
0,5,5,5,1,1,1,1,1,1,1,1,1,1,1,1,1,1,1,5,5,5,0
0,0,5,5,1,1,1,1,1,1,1,1,1,1,1,1,1,1,1,5,5,0,0
0,0,5,5,1,1,1,1,1,1,1,1,1,1,1,1,1,1,1,5,5,0,0
0,5,5,5,1,1,1,1,1,1,1,1,1,1,1,1,1,1,1,5,5,5,0
0,5,5,1,1,1,1,1,1,1,1,2,1,1,1,1,1,1,1,1,5,5,0
0,0,5,1,1,1,1,1,1,1,1,1,1,1,1,1,1,1,1,1,5,0,0
0,0,5,5,1,1,1,1,1,1,1,1,1,1,1,1,1,1,1,5,5,0,0
0,0,0,5,5,1,1,5,5,5,5,5,5,5,5,5,1,1,5,5,0,0,0
0,0,0,0,5,5,5,5,5,5,5,5,5,5,5,5,5,5,5,0,0,0,0
0,0,0,0,0,0,5,5,0,0,5,5,5,0,0,5,5,0,0,0,0,0,0
0,0,0,0,0,0,0,0,0,0,0,0,0,0,0,0,0,0,0,0,0,0,0
